[[0, 1, 4, 1, 6, 1, 3, 1, 0, 1],
 [0, 0, 0, 0, 0, 0, 0, 0, 0, 0],
 [1, 0, 1, 0, 1, 0, 1, 0, 1, 0],
 [0, 0, 0, 0, 0, 0, 0, 0, 0, 0],
 [0, 1, 0, 1, 0, 1, 0, 1, 0, 1],
 [0, 0, 0, 0, 0, 0, 0, 0, 0, 0],
 [1, 0, 1, 0, 1, 0, 1, 0, 1, 0],
 [0, 0, 0, 0, 0, 0, 0, 0, 0, 0],
 [0, 1, 0, 1, 0, 1, 0, 1, 0, 1],
 [0, 2, 2, 0, 0, 0, 1, 0, 0, 5]]