[[0, 0, 2, 0, 0, 0, 2, 0, 0, 5],
 [0, 1, 0, 1, 0, 1, 0, 1, 0, 1],
 [0, 0, 0, 0, 0, 0, 0, 0, 0, 0],
 [1, 0, 1, 0, 1, 0, 1, 0, 1, 0],
 [0, 0, 0, 0, 0, 0, 0, 0, 0, 0],
 [0, 1, 0, 1, 0, 1, 0, 1, 0, 1],
 [0, 0, 0, 0, 0, 0, 0, 0, 0, 0],
 [1, 0, 1, 0, 1, 0, 1, 0, 1, 0],
 [0, 0, 0, 0, 0, 0, 0, 0, 0, 0],
 [1, 4, 1, 0, 1, 6, 1, 0, 1, 3]]