[[0, 0, 0, 0, 0, 0, 0, 5, 2, 2],
 [0, 1, 1, 1, 1, 1, 1, 1, 1, 1],
 [0, 0, 0, 0, 0, 0, 0, 0, 0, 0],
 [1, 1, 1, 1, 1, 1, 1, 1, 1, 0],
 [0, 0, 0, 0, 0, 0, 0, 0, 0, 0],
 [0, 1, 1, 1, 1, 1, 1, 1, 1, 1],
 [0, 0, 0, 0, 0, 0, 0, 0, 0, 0],
 [1, 1, 1, 1, 1, 1, 1, 1, 1, 0],
 [6, 4, 3, 0, 0, 0, 0, 0, 0, 0],
 [1, 1, 1, 1, 1, 1, 1, 1, 1, 1]]